14  43  44  43  44  43  44  43  44  43  44  43  44  43  44  14
30 400 400   1  27   0   0   0   0   0 300   0   0 400 400  30
14   1   1   1 300   1   1 400   1   1   1 116 117 118 400  14
30   1   1   1  27   0   1   0   0   0   0 132 133 134 400  30
14  27  27  27  27   0   1 400 300   1   0 148 149 150   0  14
30  50  50  50   0   0   1   0   1   1   1   1   0   0   0  30
14   0   1   1   1   0   1   0 300   1 400   0   0   0 200  14
30   0   0   0   0  53  53   1   1 300 300   0  50   0  50  30
14 300  50  50 300  53   0 300   84  1   0  50  27  27  27  14
30   0 400  28   0   0 400 300   1   0   0   0 300   0   0  30
14   0   0 300   0   0   0 300   1   0 400   0  27 400  27  14
30   0   0   0  50  50  50   0   1   0  55  56 300 300  50  30
14   0  50  50 400   1 300   1   1   0   0  50   1   0   0  14
30   0   0  28   1   0   0 300   0   0 300 300   1   0 400  30
14 400  50   1   1   1   0  50   0   0   0  50   1 400 400  14
30  43  44  43  44  43  44  43  44  43  44  43  44  43  44  30