14  43  44  43  44  43  44  43  44  43  44  43  44  43  44  14
30   0  50  50 200   0   0   0   0   0   0  27  27  27  27  30
14 400   1   1  55  56   0 116 117 118   0   0 300   0  27  14
30 400   1   1 300   0   0 132 133 134  27  27 300   0 400  30
14 400   1   1  55  56   0 148 149 150   0   0   0  27 400  14
30 300 300  50   0   0   1   0   1   1   1   1  27  27  27  30
14   0   1   0   1  50  27  27  27   0  27  27  27 400  27  14
30  50   0   0  50 400  27   0   1   0  27 400  27   0  27  30
14 400   0  50   0   0 300   0   84  1   0   0  300  0   0  14
30  50   0   0  50 400  27   0   1   0  27   0  27   0  27  30
14 200   0   0   0  50  27  27  27  27   0   0  27   0  27  14
30   0   0  50   0   0   0   0   1  50   0  27   0   0  27  30
14   0   0   0   0   1  50   1   1   0 300  27   1  27 400  14
30   0  50 400  50   0 400   0   0   0   0   1   1   0   0  30
14 400   0   1   1   1   0   0   0   0  50  27  27  27 400  14
30  43  44  43  44  43  44  43  44  43  44  43  44  43  44  30