14  43  44  43  44  43  44  43  44  43  44  43  44  43  44  14
30 400   0   1   1   0   0   0   0   0   0   0   0   0 400  30
14   1  27  27  27 300  50 400  50 300  27 400  27   0   0  14
30   1   1  27   0   0  50  50  50   0 400  27 400   0   0  30
14   0   0  27   0   0  50 400  50   1  27 400  27   0   0  14
30   0   0   0   0   0   1   0   1   1   1   1   0   0   0  30
14   0  53   1  53   0   1   0   0   1   0 116 117 118 400  14
30   0  53 400  53   0  55  56   1   0   0 132 133 134 400  30
14   0  53  53  53   0   0   0  84   1   0 148 149 150 400  14
30   0   0   0  53   0   0   0   1   0   0   0   0   0   0  30
14   0   0   0 300   0   0   0   1   0   0   0   0   0   0  14
30  27  27  27   0  50   0 300   1  27   0   0  50   0  50  30
14  27 200  27   0  50 300   1  27   0  27   0  50 400  50  14
30  27  27  27   1  50   0   0  27  27  27   0   1  50   0  30
14  27 400   1   1  50  50 400  27   0  27 400 400  50   0  14
30  43  44  43  44  43  44  43  44  43  44  43  44  43  44  30