5 1 1 1 1 1 1 1 1 1 1 1 1 1 1 1 1 1 1 1 1 1 1 1 2 1 1 1 1 1 1 1 1 1 1 1 1 1 1 1 1 1 1 1 1 1 1 1 1 2 2 2 2 2 2 2 2 2 2 2 2 2 2 2 2 2 2 2 2 2 2 2 2 2 2 
1 1 1 1 1 1 1 1 1 1 1 1 1 1 1 1 1 1 1 1 1 1 1 1 1 1 1 1 1 1 1 1 1 1 1 1 1 1 1 1 1 1 1 1 1 1 1 1 1 2 2 2 2 2 2 2 2 2 2 2 2 2 2 2 2 2 2 2 2 2 2 2 2 2 2 
1 1 1 103 103 103 103 103 103 103 103 103 103 103 103 103 103 103 103 103 103 103 103 103 20 1 1 1 1 1 1 1 1 1 1 1 1 1 1 1 1 1 1 1 1 1 1 1 1 2 2 101 101 101 101 101 101 101 101 101 101 101 101 101 101 101 101 101 101 101 101 101 2 2 2 
1 1 1 408 0 0 0 0 0 0 0 0 0 0 0 0 0 0 0 0 0 0 0 0 15 1 1 1 1 1 1 1 1 1 1 1 1 1 1 1 1 1 1 1 1 1 1 1 1 2 2 0 0 0 0 0 0 0 0 0 0 0 0 0 0 0 0 0 0 0 0 0 2 2 2 
1 1 1 904 0 1701 1414 0 0 0 0 0 0 0 0 0 0 0 0 0 0 0 0 0 21 1 1 1 1 1 1 1 1 1 1 1 1 1 1 1 1 1 1 1 1 1 1 1 1 2 2 0 0 0 0 0 0 0 0 0 0 0 0 0 0 0 0 0 0 0 0 0 2 2 2 
1 1 1 1 5 5 1 301 0 0 0 0 0 0 0 0 0 0 0 0 0 0 0 0 0 21 1 1 1 1 1 1 1 1 1 1 1 1 1 1 1 1 1 1 1 1 1 1 1 2 2 0 0 0 0 0 0 0 0 0 0 0 0 0 0 0 0 0 1403 0 702 0 2 2 2 
1 1 1 408 0 0 0 301 0 0 0 0 0 0 0 0 0 0 0 0 0 0 0 0 0 15 1 1 1 1 1 1 1 1 1 1 1 1 1 1 1 1 1 1 1 1 1 1 1 2 2 0 1403 701 0 0 0 0 0 0 0 0 0 1801 0 0 1417 0 0 1417 0 0 2 2 2 
1 1 1 408 0 0 1801 301 0 1401 0 1801 0 0 0 0 0 0 0 0 0 0 0 0 16 1 1 1 1 1 1 1 1 1 1 1 1 1 1 1 1 1 1 1 1 1 1 1 1 2 2 0 1417 0 0 1417 0 1801 0 0 0 0 0 301 2 2 2 2 2 2 2 2 2 2 2 
1 1 1 408 0 0 0 21 5 5 22 0 1801 0 1401 0 1801 0 0 0 0 0 0 0 1 1 22 409 21 1 1 1 1 1 1 1 1 1 1 1 1 1 1 1 1 1 22 409 0 2 2 2 2 2 2 2 2 301 0 0 0 0 0 301 101 101 101 101 101 101 101 101 2 2 2 
1 1 1 408 0 0 0 0 0 0 0 0 0 21 5 22 0 1801 0 1401 0 1801 0 0 1 1 0 0 0 1 1 1 1 1 1 1 1 1 1 1 1 1 1 1 1 1 0 0 0 19 20 101 101 101 101 101 101 301 0 0 0 0 0 301 801 0 0 0 0 0 0 0 2 2 2 
1 1 1 408 0 0 0 0 0 0 0 0 0 0 0 0 0 0 21 4 22 301 0 0 21 22 0 0 0 1 1 1 1 1 1 1 1 1 1 1 1 1 1 1 1 1 0 0 0 0 0 0 0 0 0 0 0 301 0 0 0 0 0 301 0 0 0 0 802 0 403 0 2 2 2 
1 1 1 408 0 0 0 0 0 0 0 0 0 0 0 0 0 0 0 0 0 301 0 0 0 0 0 0 0 1 1 1 1 1 1 1 1 1 1 1 1 1 1 1 1 1 0 0 0 0 0 0 0 0 0 0 0 301 0 0 1403 0 0 301 0 0 0 0 403 0 403 0 2 2 2 
1 1 1 601 601 601 601 601 601 601 601 601 601 601 601 601 601 601 601 601 1 1 1 22 0 0 0 0 0 1 1 1 1 1 1 1 1 1 1 1 1 1 1 1 1 1 0 0 0 0 1801 0 0 0 0 1417 0 301 0 0 0 0 0 301 1801 0 1417 0 403 0 902 1701 2 2 2 
2 1 1 1 1 1 1 1 1 1 1 1 1 1 1 1 1 1 1 1 1 1 1 1 1 1 1 301 0 1 1 1 1 1 1 1 1 1 1 1 1 1 1 1 1 1 0 301 1 1 2 2 2 2 2 2 2 2 2 2 2 2 2 2 2 2 2 2 2 2 2 2 2 2 2 
3 3 3 3 3 3 3 3 3 3 3 3 3 3 3 3 3 3 3 3 3 3 3 3 10 1 1 301 0 1 1 1 1 1 1 1 1 1 1 1 1 1 1 1 1 1 0 301 1 1 2 2 2 2 2 2 2 2 2 2 2 2 2 2 2 2 2 2 2 2 2 2 2 2 2 
3 3 3 0 0 0 0 0 0 0 0 0 0 0 0 0 0 0 0 0 0 0 0 0 3 3 3 301 0 1 1 1 1 1 1 1 1 1 1 1 1 1 1 1 1 1 0 301 1 1 1 105 105 105 105 105 105 105 105 105 105 105 105 105 105 105 105 105 105 105 105 105 1 1 1 
3 3 3 0 0 0 0 0 0 0 0 0 0 0 0 0 0 0 0 0 0 0 0 0 3 3 3 301 0 21 1 1 1 1 1 1 1 1 1 1 1 1 1 1 1 22 0 301 1 1 1 0 0 0 0 0 0 0 0 0 0 0 0 0 0 0 0 0 0 0 1701 0 1 1 1 
3 3 3 0 0 0 0 0 0 0 0 0 0 0 0 0 0 0 0 0 0 0 905 0 3 3 3 301 0 0 0 0 0 0 0 0 412 0 412 0 0 0 0 0 0 0 0 301 1 1 1 0 0 0 0 0 0 0 0 0 0 0 0 0 0 0 0 0 0 0 1 0 1 1 1 
3 3 3 6 301 6 0 0 8 0 0 7 0 0 105 0 0 105 0 0 6 0 6 6 3 3 3 301 0 0 0 0 0 0 0 0 412 0 412 0 0 0 0 0 0 0 0 301 1 1 1 0 0 0 0 0 0 0 0 0 0 0 0 0 0 0 0 0 202 0 0 0 1 1 1 
3 3 3 0 301 0 0 0 0 0 0 0 0 0 0 0 0 0 0 0 0 0 0 0 3 3 3 301 0 0 0 0 0 0 1201 0 455 1505 459 0 1202 0 0 0 0 0 0 301 1 1 1 0 0 0 0 0 0 0 0 0 0 0 0 0 0 0 202 0 0 0 0 0 1 1 1 
3 3 3 0 301 0 0 0 0 0 0 0 0 0 0 0 0 0 0 0 0 0 0 0 7 3 0 301 12 3 3 3 3 3 3 3 3 6 3 3 3 3 3 3 6 3 10 301 0 1 22 0 0 0 0 0 0 0 0 0 0 4 0 0 0 0 0 0 0 0 0 0 1 1 1 
3 3 3 1701 301 0 0 0 0 0 0 0 0 0 0 0 0 0 0 0 0 0 0 0 0 0 0 301 7 3 3 6 3 3 3 6 3 3 3 3 3 3 3 6 3 3 8 301 0 0 0 0 0 0 0 0 0 1 0 22 0 0 0 201 0 5 0 0 0 0 0 0 1 1 1 
3 3 3 6 6 0 6 0 0 6 0 0 6 0 0 6 0 0 6 0 0 6 301 0 0 0 0 301 0 0 0 0 0 0 0 0 0 0 0 0 0 0 0 0 0 0 0 301 0 0 0 0 0 0 0 0 0 0 0 0 0 0 0 0 0 0 0 0 0 906 0 0 1 1 1 
3 3 3 0 0 0 0 0 0 0 0 0 0 0 0 0 0 0 0 0 0 0 301 0 0 0 0 301 0 0 0 0 0 0 0 0 0 0 0 0 0 0 0 0 0 0 0 301 0 0 0 0 0 21 0 20 0 0 0 0 0 0 0 0 0 0 0 5 1 4 0 0 1 1 1 
3 3 3 1406 1406 1406 1406 1406 1406 1406 1406 1406 1406 1406 1406 1406 1406 1406 1406 1406 1406 0 301 0 0 0 0 301 0 0 0 0 0 0 0 0 0 1301 0 0 0 0 0 0 0 0 0 301 0 0 0 0 0 0 0 0 0 0 0 0 0 0 0 0 0 0 0 0 0 0 0 0 1 1 1 
3 3 3 3 3 3 3 3 3 3 3 3 3 3 3 3 3 3 3 3 3 3 3 3 3 2 2 2 2 2 2 2 2 2 2 2 2 2 2 2 2 2 2 2 2 2 2 2 2 2 1 22 0 0 0 0 0 0 0 0 0 0 0 0 0 0 0 0 0 0 0 0 1 1 1 
3 3 3 3 3 3 3 3 3 3 3 3 3 3 3 3 3 3 3 3 3 3 3 3 3 2 2 2 2 2 2 2 2 2 2 2 2 2 2 2 2 2 2 2 2 2 2 2 2 2 1 0 0 0 0 0 0 0 0 0 0 0 0 0 0 0 0 0 0 0 0 0 1 1 1 
3 3 3 3 3 3 3 3 3 3 3 3 3 3 3 3 3 3 3 3 3 3 3 3 3 2 2 2 2 2 2 2 2 2 2 2 2 2 2 2 2 2 2 2 2 2 2 2 2 2 1 0 0 0 0 0 0 0 0 0 0 0 0 0 0 0 0 0 0 0 0 0 1 1 2 
