3 3 3 3 6 3 3 3 3 3 3 3 3 3 3 3 6 3 3 3 3 3 3 3 3 
3 2 2 2 2 2 2 2 2 2 2 2 2 2 2 2 2 2 2 2 2 2 2 2 3 
3 2 1 1 1 1 4 1 1 1 1 5 1 1 1 4 1 1 5 1 1 1 4 1301 6 
3 2 1 1 101 101 101 101 101 101 101 101 101 101 101 101 101 101 101 101 101 1 1 2 6 
6 2 1 22 0 0 0 0 0 0 0 0 0 0 0 0 0 0 0 0 0 21 1 2 6 
3 2 1 0 0 0 0 0 0 0 0 0 0 0 0 0 0 0 0 0 0 0 1 2 3 
3 2 4 0 0 0 0 0 0 0 0 0 0 0 0 0 0 0 0 0 0 0 1 2 3 
3 2 5 0 0 0 0 0 0 0 0 0 0 0 0 0 0 0 0 0 0 0 1 2 6 
6 2 1 0 0 0 0 0 0 0 0 0 0 0 0 0 0 0 0 0 0 0 1 2 6 
6 2 1 0 0 0 0 0 0 0 0 0 0 0 0 0 0 0 0 0 0 0 1 2 3 
6 2 1 1701 0 0 0 0 0 0 0 0 0 0 0 0 0 0 0 0 0 1701 1 2 3 
3 2 5 5 0 0 1201 1202 0 0 0 0 0 0 0 0 0 0 0 0 0 1 4 2 3 
3 2 2 2 2 2 2 2 2 2 2 2 2 2 2 2 2 2 2 2 2 2 2 2 3 
6 3 6 3 6 3 3 3 6 6 3 3 6 6 3 3 3 3 3 3 3 3 3 3 3 
