6 6 6 6 6 6 105 1101 7 6 6 6 6 105 105 105 105 105 105 6 6 6 6 6 6 
6 1101 0 0 0 0 0 0 0 0 0 0 0 0 0 0 0 0 0 0 0 0 0 0 0 
6 0 0 0 0 0 204 6 6 0 0 0 0 0 0 205 0 3 0 0 0 0 3 3 6 
6 0 0 0 204 0 6 6 6 0 0 0 0 205 0 0 0 0 105 6 6 6 0 0 6 
6 204 0 0 0 0 6 6 6 6 6 204 204 6 0 0 0 0 0 0 0 0 0 0 6 
3 0 0 0 204 0 6 1301 0 105 1101 0 0 6 601 6 6 10 0 0 0 0 0 0 6 
6 0 0 0 0 0 6 103 204 0 0 0 0 0 0 0 0 6 10 0 0 13 301 0 6 
6 0 0 0 0 0 6 0 0 0 0 205 0 0 0 0 0 6 601 601 6 6 301 0 6 
6 0 0 0 0 0 6 0 0 12 601 601 601 6 0 0 0 0 6 6 7 6 301 0 3 
6 0 0 0 0 0 6 1701 0 3 6 6 6 6 6 6 0 0 0 0 0 6 301 0 3 
6 1101 205 0 6 6 6 3 601 6 1101 0 0 0 0 0 0 0 0 0 0 0 301 0 6 
6 0 0 0 6 6 6 1101 6 0 0 0 0 0 0 0 0 0 0 0 0 0 301 0 6 
6 1201 1202 0 6 6 6 0 0 0 0 0 0 0 0 0 0 6 0 0 0 0 301 0 6 
6 6 6 6 6 6 6 6 6 6 6 6 6 6 6 6 6 6 601 601 6 6 512 6 6 
