0 0 0 0 0 0 0 0 0 0 0 0 0 0 0 0 0 0 0 0 0 0 0 0 0 
0 0 0 0 0 0 0 0 0 0 0 0 0 0 0 0 0 0 0 0 0 439 404 404 404 
0 0 0 0 0 0 0 0 0 0 0 0 0 0 0 0 0 0 1406 0 1701 902 0 0 0 
0 0 0 0 0 0 0 0 0 0 0 1405 1406 0 0 0 0 0 0 0 0 436 461 438 0 
0 0 0 0 0 0 0 0 0 601 0 0 0 0 0 0 0 0 0 0 0 0 503 503 0 
0 0 0 0 0 0 0 0 0 0 0 0 0 0 204 0 0 0 0 0 0 0 0 502 0 
0 0 0 0 0 0 0 0 0 0 0 0 0 0 0 0 0 0 0 0 0 0 0 502 0 
0 0 0 205 0 0 0 0 0 0 0 0 0 0 0 0 0 0 0 0 0 0 0 502 0 
0 0 0 0 0 0 0 0 0 0 0 0 0 0 0 1701 0 0 0 0 0 0 0 502 0 
0 205 0 0 0 1401 0 0 0 0 0 0 0 0 0 0 301 0 0 0 0 0 0 502 0 
0 0 0 301 0 0 0 0 0 0 0 0 0 0 0 0 301 0 0 0 0 0 0 502 0 
0 0 0 301 0 0 0 0 0 0 0 0 0 0 0 0 301 0 0 0 0 0 0 502 0 
0 0 0 301 0 0 0 1406 1701 1403 0 1404 0 1401 1402 0 301 0 0 0 0 0 0 502 0 
0 0 0 0 0 0 0 0 0 0 0 0 0 0 0 0 0 0 205 205 0 0 205 0 0 
