434 0 0 0 0 0 0 403 0 0 0 0 0 0 0 0 0 0 439 404 404 404 404 404 404 404 404 404 404 404 404 404 404 404 404 
408 0 0 0 0 0 0 403 0 0 0 439 404 404 404 404 404 404 437 0 0 0 0 0 0 0 0 0 0 0 0 0 0 0 0 
408 0 0 0 0 0 0 403 0 0 0 403 0 0 0 0 0 0 0 0 0 0 0 0 0 0 0 0 0 0 1403 0 0 0 0 
408 0 0 0 0 0 0 436 404 801 404 437 0 0 0 0 0 0 0 0 0 0 0 0 0 0 0 0 0 0 0 0 0 0 0 
408 0 0 0 0 0 0 0 0 0 0 0 0 0 0 0 0 0 0 0 0 0 0 0 0 0 0 102 101 101 101 101 101 101 0 
408 102 101 101 101 101 101 0 0 0 0 0 0 0 0 0 0 0 0 0 0 0 0 103 103 103 103 0 0 0 0 0 0 0 0 
432 407 407 407 407 407 434 103 103 0 103 1402 0 0 0 0 0 0 0 0 103 103 103 0 0 0 0 0 0 0 0 0 0 0 0 
0 0 0 0 0 0 432 407 807 407 434 103 103 103 103 1402 0 0 0 0 0 0 0 0 0 0 0 0 0 0 0 0 0 0 0 
0 0 0 0 0 0 0 0 0 0 408 0 0 0 0 103 103 103 0 0 0 0 0 0 0 0 0 0 0 0 0 0 701 0 0 
0 0 0 0 0 0 0 0 0 0 408 0 0 0 0 0 0 0 0 0 0 0 0 0 0 0 0 0 0 0 0 0 0 0 0 
0 0 0 0 0 0 0 0 0 0 408 0 0 0 0 0 0 0 0 0 0 0 0 0 0 0 0 0 0 0 0 0 0 0 0 
0 0 0 0 0 0 0 0 0 0 408 0 0 0 0 0 0 0 0 0 0 0 0 0 0 0 0 0 0 0 0 0 0 0 0 
0 0 0 0 707 0 0 103 0 0 408 103 0 0 0 103 0 0 0 103 103 601 601 0 0 0 0 0 0 601 601 601 601 601 0 
0 104 104 104 104 104 104 0 0 0 408 0 104 104 104 0 104 104 104 0 0 0 0 0 0 0 0 0 0 0 0 0 0 0 0 
