0 203 203 203 203 203 403 203 203 203 203 203 203 203 408 0 408 203 203 203 203 203 203 203 0 
0 0 0 0 0 0 403 0 0 0 0 0 0 0 408 0 408 0 0 0 0 0 0 0 701 
404 404 404 404 401 801 437 0 0 0 0 0 0 0 408 0 408 0 0 0 0 0 0 0 0 
0 0 0 0 0 0 0 0 0 0 0 0 0 0 408 0 408 0 0 0 0 0 0 0 0 
0 0 0 0 0 0 1801 1401 0 0 0 1801 0 0 408 0 408 0 0 0 0 0 0 0 0 
0 0 0 0 0 0 0 0 0 0 0 0 0 0 408 0 408 0 0 0 203 203 203 203 0 
0 203 203 203 203 203 203 203 203 203 203 0 0 0 408 0 408 0 0 0 0 0 0 0 0 
0 0 0 0 0 0 0 0 0 0 0 0 0 0 408 0 408 0 0 0 0 0 0 0 0 
404 404 404 404 404 404 404 404 438 0 0 0 0 0 408 0 408 0 0 0 0 0 0 0 0 
0 0 0 0 0 0 0 0 802 0 0 0 0 0 408 0 408 0 0 0 0 0 0 0 0 
0 0 0 702 0 0 0 0 403 0 0 0 0 0 432 807 433 0 0 0 0 0 0 0 0 
0 0 0 0 0 0 0 0 403 0 0 0 707 0 0 0 0 0 0 0 0 0 0 0 0 
0 0 0 0 0 0 0 0 403 0 0 0 0 0 0 0 0 0 0 0 0 0 0 0 0 
0 0 0 0 0 0 0 0 403 0 0 0 0 0 0 0 0 0 0 0 0 0 0 0 0 
