1 1 1 1 1 1 1 1 1 1 1 1 1 1 1 1 1 1 1 1 1 1 1 1 1 1 1 1 1 1 1 1 1 1 1 
1 22 0 0 0 0 21 22 0 0 21 22 0 0 21 22 0 0 21 22 0 0 21 22 0 0 21 22 0 0 0 0 0 21 1 
1 0 0 0 0 0 0 0 0 0 0 0 0 0 0 0 0 0 0 0 0 0 0 0 0 0 0 0 0 0 0 0 0 0 1 
1 0 0 0 0 0 0 0 0 505 0 0 0 0 0 0 0 0 0 0 0 0 0 0 0 0 0 0 0 0 0 0 0 1701 1 
1 0 0 1301 0 0 0 0 0 502 0 0 0 0 0 0 0 0 0 0 0 0 0 0 0 0 0 2 2 2 2 2 2 2 1 
1 2 2 2 2 2 2 1402 0 502 0 1801 0 0 0 0 0 0 0 0 0 0 0 21 1 1 22 0 0 0 0 0 0 1102 4 
1 0 0 0 0 0 0 21 5 4 22 0 0 0 0 1801 0 0 0 301 1 1 22 0 0 0 0 0 0 0 0 0 0 0 15 
1 0 0 0 0 0 0 301 506 0 0 21 1 5 22 0 0 0 1801 301 0 0 0 0 0 0 0 0 0 1413 0 0 0 0 1 
22 0 0 0 0 0 0 301 501 0 0 0 0 0 0 21 1 22 0 301 0 0 0 0 0 0 0 0 0 0 0 0 0 0 1 
1 0 0 0 0 0 0 301 501 0 0 0 0 0 0 0 0 0 0 301 0 0 0 0 0 0 0 0 0 0 0 0 0 0 1 
1 0 0 0 0 0 0 301 501 0 0 0 0 0 0 0 0 0 0 301 0 0 0 0 0 0 0 0 0 7 6 6 6 6 1 
1 0 0 0 0 0 0 301 501 0 0 0 0 0 0 0 0 0 0 301 0 0 1801 0 0 1401 0 0 0 1801 0 0 0 0 1 
1 1201 1202 0 0 0 0 1 501 0 0 1 1402 0 0 1 0 0 0 1 1 601 601 6 6 6 6 6 6 601 601 601 601 601 1 
1 1 1 1 1 1 1 1 1 1 1 1 1 1 1 1 1 1 1 1 1 1 1 1 1 1 1 1 1 1 1 1 1 1 1 
