1 1 1 1 1 1 1 1 1 1 1 1 1 1 1 1 1 1 1 1 1 1 1 1 1 1 1 1 1 1 1 1 1 1 1 1 1 1 1 1 
1 0 0 0 0 0 0 0 0 407 807 0 0 0 0 801 0 0 1 0 0 504 0 0 504 0 0 504 301 0 4 4 5 0 0 0 0 0 1102 1 
1 0 0 0 0 0 0 0 0 0 0 0 0 0 0 0 0 0 1 0 0 502 0 0 502 0 0 502 301 1414 0 5 0 0 0 0 0 0 0 1 
1 1 1 1 1 1 1 1 301 1 1 301 1 1 1 1 1 301 1 1 1 1 301 301 1 1 1 1 301 0 0 301 0 0 0 1403 0 0 0 1 
1 0 0 0 0 0 0 0 301 0 1 301 0 0 1 0 0 301 808 0 0 0 301 301 0 0 0 1 301 0 0 301 0 0 1 1 1 1 1 1 
1 0 0 0 0 0 0 0 301 0 1 301 0 0 1 0 0 301 408 0 0 0 301 301 0 0 0 1 301 0 0 301 0 0 1 1 1 1 1 1 
1 301 1 1 1 1 1 1 1 1 1 1 1 301 1 301 1 1 1 1 301 1 1 1 1 301 1 1 301 0 0 301 0 0 1 1 1 1 1 1 
1 301 0 0 0 0 0 0 0 0 1 0 0 301 1 301 0 0 1 0 301 0 1 1 0 301 0 1 301 0 0 301 0 0 301 0 0 0 1412 1 
1 301 0 0 0 0 0 0 0 0 1 0 0 301 1 301 0 0 1 0 301 0 1 1 0 301 0 1 301 0 0 0 0 0 301 0 0 0 0 1 
1 1 1 1 1 1 1 1 301 1 1 301 1 1 1 1 1 301 1 301 1 1 1 1 1 1 301 1 301 0 0 0 0 0 0 0 0 0 0 1 
1 0 0 0 0 0 0 0 301 0 1 301 0 0 1 0 0 301 1 301 0 0 0 0 0 0 301 1 301 0 0 0 301 0 0 0 0 0 0 1 
1 1201 1202 0 0 0 0 0 301 0 1 301 0 0 1 0 0 301 1 301 0 0 0 0 0 0 301 1 1 1 301 1416 301 0 0 0 0 0 0 1 
1 3 3 0 0 0 0 0 301 0 1 301 0 0 1 0 0 301 1 301 0 0 1701 1702 0 0 301 1 1801 1801 301 1801 301 0 0 0 0 0 1301 1 
1 1 1 1 1 1 1 1 1 1 1 1 1 1 1 1 1 1 1 1 1 1 1 1 1 1 1 1 601 601 601 601 601 601 601 601 1 601 1 1 
