0 0 0 0 0 0 0 0 0 0 0 0 0 0 0 3 0 0 0 0 0 0 0 0 0 
0 0 0 0 0 0 0 0 0 0 0 0 0 0 0 11 0 0 0 0 0 0 0 0 0 
0 0 0 0 0 0 0 0 0 1605 409 411 411 442 0 3 0 443 411 409 1611 0 0 0 0 
0 0 0 0 0 0 0 0 0 0 0 0 0 412 0 9 0 412 0 0 0 0 0 0 0 
0 0 0 0 0 0 0 0 0 0 0 0 0 412 0 3 0 412 0 0 104 104 104 104 0 
0 104 104 104 601 601 601 104 104 104 104 0 0 412 0 13 0 412 0 0 0 0 0 0 0 
0 0 0 0 0 0 0 0 0 0 0 0 0 412 0 3 0 412 0 0 0 0 0 0 0 
0 0 0 0 0 0 0 0 0 0 0 0 0 412 0 3 0 412 0 0 0 0 0 0 0 
0 0 0 0 0 0 0 0 0 0 0 0 0 412 0 8 0 412 0 0 0 0 0 0 0 
0 0 0 0 0 0 0 0 0 0 0 0 0 412 0 0 0 412 0 0 0 0 0 0 0 
0 0 0 0 0 0 0 0 0 0 0 0 0 412 0 0 0 412 0 0 0 0 0 0 0 
0 0 0 0 443 411 411 1505 411 411 411 411 411 451 411 411 411 441 0 0 0 0 0 0 0 
0 104 104 104 104 104 104 104 104 104 104 104 104 104 104 104 104 104 104 104 104 104 104 104 0 
0 0 0 0 412 0 0 0 0 0 0 0 0 0 0 0 0 0 0 0 0 0 0 0 0 
