1 1 1 1 1 1 1 1 1 1 1 1 1 1 1 1 1 1 1 1 1 1 1 1 1 
1 1101 0 0 0 0 0 0 0 0 0 0 0 0 16 1 1 0 0 0 0 0 0 0 1 
1 0 0 1415 0 0 0 0 0 509 0 0 0 0 1 1 16 0 0 0 507 1413 0 0 1 
1 0 0 0 0 0 0 0 0 501 0 0 0 0 1 1 1 0 0 0 501 0 1301 0 1 
1 0 1701 0 0 0 0 0 0 501 0 0 0 0 15 1 1 0 0 301 1 1 1 1 1 
1 1 1 1 601 601 601 1 1 1 1 301 0 0 1 1 1 0 0 301 1 1 1 1 1 
1 1 1 1 1 1 1 1 1 1 1 301 0 0 1 1 1 0 0 301 0 0 0 0 1 
1 2 2 2 2 2 2 2 2 2 20 301 0 0 1 1 16 0 0 301 0 0 0 0 1 
1 0 0 0 0 0 0 0 0 0 0 301 0 0 1 1 1 0 0 301 0 0 0 0 1 
1 0 0 0 0 0 0 0 1412 0 0 301 0 0 21 1 1 0 0 301 0 0 0 0 1 
1 0 0 0 0 0 0 0 0 0 0 301 0 0 0 0 0 0 0 301 0 0 1403 0 1 
1 1201 1202 0 0 0 0 0 0 0 0 301 0 0 0 0 0 0 0 301 0 0 0 0 1 
1 1 1 1 1 1 1 1 1 1 1 1 1 1 1 1 1 1 1 1 1 1 1 1 1 
1 1 1 1 1 1 1 1 1 1 1 1 1 1 1 1 1 1 1 1 1 1 1 1 1 
