1 1 4 4 4 4 4 4 1 1 1 4 4 4 4 4 4 4 3 3 3 1 1 1 1 4 4 4 6 6 6 6 6 4 4 4 4 4 4 4 4 1 101 101 101 101 4 4 1 6 6 6 6 6 4 4 4 4 1 1 1 1 1 1 4 4 4 4 4 4 4 4 4 4 4 
1 22 105 104 104 104 104 104 104 104 104 104 104 104 104 104 104 104 104 104 104 104 104 104 104 104 104 104 105 105 105 105 105 104 104 104 104 104 104 104 104 104 0 0 0 0 105 105 105 105 105 105 105 105 104 104 104 104 104 104 104 104 104 104 104 104 104 104 104 104 104 104 104 104 104 
1 0 0 0 0 0 0 0 0 0 0 0 0 0 0 0 0 0 0 0 0 0 0 0 0 0 0 0 0 0 0 0 0 0 0 0 0 0 0 0 0 0 0 1004 1002 403 0 0 0 0 0 0 0 0 0 1801 0 0 1411 0 0 0 1801 0 0 0 0 0 0 0 0 0 0 0 0 
1 6 0 0 0 0 0 0 0 0 0 0 0 0 0 0 0 0 0 0 0 0 0 0 0 0 0 0 0 0 0 0 0 0 0 0 0 0 0 0 0 0 0 0 0 0 0 0 0 0 0 0 0 0 0 0 0 0 0 0 0 0 0 0 0 0 0 0 0 0 0 0 0 0 0 
1 3 0 0 301 21 4 0 1407 1 22 0 0 21 4 1401 1401 4 22 0 0 21 4 1405 1405 4 22 0 1413 21 4 1402 1402 4 22 0 1413 21 4 1408 0 4 0 1 1 0 4 1405 1405 4 22 0 0 21 1 1405 1 22 0 0 21 4 1405 1405 4 22 1801 1301 1405 1406 1405 1406 1405 0 0 
1 3 0 0 301 0 4 4 4 4 0 0 0 0 4 4 4 4 0 0 0 0 4 4 4 4 0 0 0 0 4 4 4 4 0 0 0 0 4 4 4 4 0 0 0 0 4 4 4 4 0 0 0 0 4 4 4 0 0 0 0 4 4 4 4 0 0 1 601 601 601 601 601 601 601 
1 3 0 0 301 0 8 0 0 7 0 0 0 0 8 0 0 7 0 0 0 0 8 0 0 7 0 0 1413 0 8 0 0 7 0 0 1413 0 8 0 0 7 0 0 0 0 8 0 0 7 0 0 0 0 8 0 7 0 0 0 0 8 0 0 7 0 0 0 0 0 0 0 0 0 0 
1 3 1701 0 301 0 0 0 0 0 0 0 0 0 0 0 0 0 0 0 0 0 0 0 0 0 0 0 0 0 0 0 0 0 0 0 0 0 0 205 0 0 0 0 0 0 0 0 205 0 0 0 0 0 0 0 0 0 0 0 0 0 0 0 0 0 0 0 0 0 0 0 0 3 4 
1 3 2 2 2 2 2 2 2 2 2 2 0 0 0 0 0 0 0 0 0 0 0 0 0 0 0 0 1413 0 0 0 0 0 0 0 1413 0 0 3 0 301 0 0 0 0 301 0 3 0 0 0 0 0 0 0 0 0 0 0 0 0 0 0 0 0 0 0 0 0 0 0 0 3 4 
1 3 102 102 102 102 102 102 102 102 102 102 2 0 0 0 0 0 0 0 0 0 0 0 0 0 0 0 0 0 0 0 0 0 0 0 0 0 0 3 0 301 0 0 0 0 301 0 3 0 0 0 0 0 0 0 0 0 0 0 0 0 0 0 0 0 0 0 0 0 0 0 0 3 1 
1 3 0 0 0 0 0 0 0 0 0 0 104 2 0 0 0 0 0 0 0 0 0 0 0 0 0 0 1413 0 0 0 0 0 0 0 1413 0 0 3 0 301 0 0 0 0 301 0 3 0 0 0 0 0 0 0 0 0 0 0 0 0 0 0 0 0 0 0 0 0 0 0 0 3 1 
1 3 0 0 0 0 0 0 0 0 0 0 0 104 2 2 2 2 2 2 2 2 2 2 2 2 2 2 2 0 0 0 0 0 0 0 0 0 1701 3 0 301 0 0 0 0 301 0 3 0 0 0 0 0 0 0 0 0 0 0 0 0 0 0 0 0 0 0 0 0 0 0 0 6 4 
1 6 0 0 0 0 0 0 0 0 0 0 0 0 104 104 104 104 104 104 104 104 104 104 104 104 104 104 104 0 0 2 2 2 2 2 2 2 2 3 0 301 0 0 0 0 301 0 3 0 0 0 0 0 0 0 0 0 0 0 0 0 0 0 0 0 0 0 0 0 0 0 0 6 4 
1 6 0 0 0 0 0 0 0 0 0 0 0 0 0 0 0 0 0 0 0 0 0 0 0 0 0 0 0 0 2 104 104 104 104 104 104 104 104 3 0 301 0 0 0 0 301 0 3 0 0 0 0 0 0 0 0 0 0 0 0 0 0 0 0 0 0 0 0 0 0 0 0 6 4 
1 6 0 0 0 0 0 0 0 0 0 0 0 0 0 0 0 0 0 0 0 0 0 0 0 0 0 0 0 2 102 0 0 0 0 0 0 0 0 3 0 301 0 0 0 0 301 0 3 0 0 0 0 0 0 0 0 0 0 0 0 0 0 0 0 0 0 0 0 0 0 0 0 6 4 
1 6 0 0 0 0 0 0 0 0 0 0 0 0 0 0 0 0 0 0 0 0 0 0 0 0 0 0 2 102 0 0 0 0 0 0 0 0 0 3 0 301 0 0 0 0 301 0 3 0 0 0 0 0 0 0 0 0 0 0 0 0 0 0 0 0 0 0 0 0 0 0 0 6 4 
1 6 0 0 0 0 0 0 0 0 0 0 0 0 0 0 0 0 0 1801 0 0 0 0 0 1405 0 2 102 0 0 0 0 0 0 0 0 0 0 3 0 301 0 0 0 0 301 0 3 0 0 0 0 0 0 0 0 0 0 0 0 0 0 0 0 0 0 0 0 0 0 0 0 6 4 
6 6 0 0 0 0 0 0 0 0 0 0 0 0 0 0 0 0 0 0 2 2 2 2 2 2 2 102 0 0 0 0 0 0 0 0 0 0 0 3 0 301 0 0 0 0 301 0 3 0 0 0 0 0 0 0 0 0 0 0 0 0 0 0 0 0 0 0 0 0 0 0 0 6 1 
6 6 0 0 0 0 0 0 0 0 0 0 0 0 0 0 0 0 0 2 102 102 102 102 102 102 102 0 0 0 0 0 0 0 0 0 0 0 0 0 0 301 0 0 0 0 301 0 105 0 0 0 0 0 0 0 0 0 0 0 0 0 0 0 0 0 0 0 0 0 0 0 0 6 4 
6 6 0 0 0 0 0 0 0 0 0 1801 0 0 0 0 1405 0 2 102 0 0 0 0 0 0 0 0 0 0 0 0 0 0 0 0 0 0 0 0 0 301 0 0 0 0 301 0 204 0 0 0 0 0 0 0 0 0 0 0 0 0 0 0 0 0 0 0 0 0 0 0 0 6 4 
1 3 0 0 0 0 0 0 0 0 0 0 2 2 2 2 2 2 102 0 0 0 0 0 0 0 0 0 0 0 0 0 0 0 0 0 0 0 0 1 0 301 0 0 0 0 301 0 1 0 0 0 0 0 0 0 0 0 0 0 0 0 0 0 0 0 0 0 0 0 0 0 0 6 4 
1 3 0 0 0 0 0 0 0 0 0 2 102 102 102 102 102 102 0 0 0 0 0 0 0 0 0 0 0 0 0 0 0 0 0 0 0 0 0 1 0 301 0 0 0 0 301 0 1 0 0 0 0 0 0 0 0 0 0 0 0 0 0 0 0 0 0 0 0 0 0 0 0 6 4 
1 3 0 0 0 0 0 0 0 0 2 102 0 0 0 0 0 0 0 0 0 0 0 0 0 0 0 0 0 0 0 0 0 0 0 0 0 0 0 5 0 301 0 0 0 0 301 0 1 0 0 0 0 0 0 0 0 0 0 0 0 0 0 0 0 0 0 0 0 0 0 0 0 6 4 
1 3 1701 1405 0 0 0 0 1801 0 102 0 0 0 0 0 0 0 0 0 0 0 0 0 0 0 0 0 0 0 0 0 0 0 0 0 0 0 0 5 0 301 0 0 0 0 301 0 1 0 0 0 0 0 0 0 0 0 0 0 0 0 0 0 0 0 0 0 0 0 0 0 0 6 4 
1 6 2 2 2 2 2 2 2 0 0 0 0 0 0 0 0 0 0 0 0 0 0 0 0 0 0 0 0 0 0 0 0 0 0 0 0 0 0 5 0 301 0 0 0 0 301 0 1 0 0 0 0 0 0 0 0 0 0 0 0 0 0 0 0 0 0 0 0 0 0 0 0 3 4 
1 6 102 102 102 102 102 102 102 2 0 0 0 0 0 0 0 0 0 0 0 0 0 0 0 0 0 0 0 0 0 0 0 0 0 0 0 0 0 5 0 301 0 0 0 0 301 0 1 0 0 0 0 0 0 0 0 0 0 0 0 0 0 0 0 0 0 0 0 0 0 0 0 3 4 
1 6 0 0 0 0 0 0 0 102 2 0 1405 1405 0 0 0 0 1801 0 0 0 0 0 0 0 0 0 0 0 0 0 0 0 0 0 0 0 0 5 0 301 0 0 0 0 301 0 1 0 0 0 0 0 0 0 0 0 0 0 0 0 0 0 0 0 1701 1702 1701 1702 0 0 0 3 1 
1 6 0 0 0 0 0 0 0 0 102 2 2 2 2 2 2 2 0 0 0 0 0 0 0 0 0 0 0 0 0 0 0 0 0 0 0 0 0 1 0 301 0 0 0 0 301 0 5 0 0 0 0 0 0 0 0 0 0 0 0 0 0 0 0 0 103 103 103 103 0 0 0 3 4 
1 6 0 0 0 0 0 0 0 0 0 105 105 105 105 105 105 105 2 0 0 0 0 0 0 0 0 0 0 0 0 0 0 0 0 0 0 0 0 1 0 301 0 0 0 0 301 0 5 0 1701 1702 0 0 0 0 1701 1702 0 0 0 0 0 0 0 103 0 0 0 0 103 0 0 6 4 
1 6 0 0 0 0 0 0 0 0 0 0 0 0 0 0 0 0 105 2 0 0 0 0 0 0 0 0 0 0 0 0 0 0 0 0 0 0 0 1 0 301 0 0 0 0 301 0 5 0 101 101 101 101 101 101 101 101 0 0 0 0 0 0 103 0 0 0 0 0 0 103 0 6 4 
1 6 0 0 0 0 0 0 0 0 0 0 0 0 0 0 0 0 0 105 1801 0 0 1405 0 1406 0 0 0 0 1406 1701 1801 0 0 0 0 0 0 1 0 301 0 0 0 0 301 0 5 0 0 0 0 102 0 0 0 0 0 0 0 0 0 0 103 0 0 0 0 0 0 103 0 6 4 
1 6 0 0 0 0 0 0 0 0 0 0 0 0 0 0 0 0 0 0 0 2 2 2 2 2 2 2 2 2 2 2 0 0 0 0 0 0 0 1 0 301 0 0 0 0 301 0 5 0 0 0 0 102 0 0 0 0 0 0 0 0 0 0 103 103 103 103 103 103 103 0 0 6 4 
1 6 0 0 0 0 0 0 0 0 0 0 0 0 0 0 0 0 0 0 2 105 105 105 105 105 105 105 105 105 105 105 0 0 0 0 0 0 0 1 0 301 0 0 0 0 301 0 1 0 0 0 0 102 0 0 0 0 0 0 0 0 0 0 103 0 103 0 0 0 0 0 0 3 4 
1 6 0 0 0 0 0 0 0 0 0 0 0 0 0 0 0 0 0 2 105 0 0 0 0 0 0 0 0 0 0 0 0 0 0 0 0 0 0 1 0 301 0 0 0 0 301 0 1 0 0 0 0 102 0 0 0 0 0 0 0 0 0 0 103 0 0 103 0 0 0 0 0 3 1 
1 6 0 0 0 0 0 0 0 0 0 0 0 0 0 0 0 0 2 105 0 0 0 0 0 0 0 0 0 0 0 0 0 0 0 0 0 0 0 1 0 301 0 0 0 0 301 0 1 0 0 0 0 102 0 0 0 0 0 0 0 0 0 0 103 0 0 0 103 0 0 0 0 3 1 
1 3 0 0 0 0 1405 1405 0 0 0 0 0 1406 0 0 0 1801 0 0 0 0 0 0 0 0 0 0 0 0 0 0 0 0 0 0 0 0 0 1 0 301 0 0 0 0 301 0 1 0 0 0 0 102 0 0 0 0 0 0 0 0 0 0 103 0 0 0 0 103 0 0 0 3 1 
1 3 1 2 2 2 2 2 2 2 2 2 2 2 2 2 2 2 0 0 0 0 0 0 0 0 0 0 0 0 0 0 0 0 0 0 0 0 0 1 0 301 0 0 0 0 301 0 1 0 0 0 0 102 0 0 0 0 0 0 0 0 0 0 103 0 0 0 0 0 103 0 0 3 4 
3 3 1 105 105 105 105 105 105 105 105 105 105 105 105 105 105 105 2 0 1405 0 0 0 0 0 0 0 0 0 0 0 1801 0 0 0 0 0 0 1 0 301 0 0 0 0 301 0 1 0 0 0 0 102 0 0 0 0 0 0 0 0 0 0 0 0 103 103 103 103 0 0 0 3 4 
3 3 1 0 0 0 0 0 0 0 0 0 0 0 0 0 0 0 105 2 2 2 2 2 2 2 2 2 2 2 2 2 0 0 0 0 0 0 0 1 0 301 0 0 0 0 301 0 1 0 0 0 0 0 0 0 0 0 0 0 0 0 0 0 1701 103 0 0 0 0 103 0 0 3 4 
3 3 1 0 0 0 0 0 0 0 0 0 0 0 0 0 0 0 0 105 105 105 105 105 105 105 105 105 105 105 105 105 2 0 0 0 0 0 0 1 0 301 0 0 0 0 301 0 1 0 0 0 0 0 0 1701 1702 0 0 0 0 0 0 0 103 0 0 0 0 0 0 103 0 3 4 
1 3 1 0 0 0 0 0 0 0 0 0 0 0 0 0 0 0 0 0 0 0 0 0 0 0 0 0 0 0 0 0 105 2 1801 0 1405 0 1701 1 0 301 0 0 0 0 301 0 1 0 0 0 0 0 0 101 101 0 0 0 0 0 0 0 103 0 0 0 0 0 0 103 0 3 4 
1 3 1 0 0 0 0 0 0 0 0 0 0 0 0 0 0 0 0 0 0 0 0 0 0 0 0 0 0 0 0 0 0 0 0 2 2 2 2 1 0 301 0 0 0 0 301 0 1 0 0 0 0 0 101 0 0 101 0 0 0 0 0 0 103 0 0 0 0 0 0 103 0 3 4 
1 3 0 0 0 0 0 0 0 0 0 0 0 0 0 0 0 0 0 0 0 0 0 0 0 0 0 0 0 0 0 0 0 0 2 101 101 101 101 1 0 301 0 0 0 403 301 0 1 0 0 0 0 101 0 0 0 0 101 0 0 0 0 0 103 103 103 103 103 103 103 0 0 3 4 
1 3 0 0 0 0 0 0 0 0 0 0 0 0 0 0 0 0 0 0 0 0 0 0 0 0 0 0 0 0 0 0 0 2 0 0 0 0 0 1 0 301 0 0 0 0 301 0 1 0 0 0 101 101 101 101 101 101 101 101 0 0 0 0 103 0 0 0 0 0 0 0 0 3 4 
1 3 1 0 0 0 0 0 0 0 0 0 0 0 0 0 0 0 0 0 0 0 0 0 0 0 0 0 0 0 0 0 2 102 0 0 0 0 0 1 0 301 0 0 0 0 301 0 1 0 0 101 0 0 0 0 0 0 0 0 101 0 0 0 103 0 0 0 0 0 0 0 0 3 4 
1 3 1 0 0 0 0 0 0 0 0 0 0 0 0 0 0 0 0 0 0 0 0 1801 0 1405 0 1405 0 0 0 2 102 0 0 0 0 0 0 1 0 301 1002 0 0 0 301 0 1 0 101 0 0 0 0 0 0 0 0 0 0 101 0 0 103 0 0 0 0 0 0 0 0 3 4 
1 3 1 0 0 0 0 0 0 0 0 0 0 0 0 0 0 0 0 0 0 0 0 0 2 2 2 2 2 2 2 102 0 0 0 0 0 0 0 1 0 301 1 0 0 1 301 0 1 101 0 0 0 0 0 0 0 0 0 0 0 0 101 0 103 0 0 0 0 0 0 0 0 3 1 
1 3 1 0 0 0 0 0 0 0 0 0 0 0 0 0 0 0 0 0 0 0 0 2 102 102 102 102 102 102 102 0 0 0 0 0 0 0 0 1 101 301 101 101 101 101 301 101 1 0 0 0 0 0 0 0 0 0 0 0 0 0 0 0 0 0 0 0 0 0 0 0 0 3 4 
3 3 1 0 0 0 0 0 0 0 0 0 0 0 1801 1701 0 0 1405 0 0 0 2 102 0 0 0 0 0 0 0 0 0 0 0 0 0 0 0 2 0 301 0 0 0 0 301 0 2 0 0 0 0 0 0 0 0 0 0 0 0 0 0 0 0 0 0 0 0 0 0 0 0 3 4 
3 3 1 0 0 0 0 0 0 0 0 0 0 0 0 2 2 2 2 2 2 2 102 0 0 0 0 0 0 0 0 0 0 0 0 0 0 0 0 201 1201 301 0 0 0 0 301 1202 202 718 0 0 0 0 0 0 1107 0 1108 0 0 0 0 0 0 0 0 0 0 0 0 0 0 3 4 
1 3 1 0 0 0 0 0 0 0 0 0 0 0 2 102 102 102 102 102 102 102 0 0 0 0 0 0 0 0 0 0 0 0 0 0 0 0 0 2 1 301 0 0 0 717 301 1 2 301 0 0 0 0 0 1107 601 0 601 0 0 0 0 0 0 0 0 0 0 0 0 0 0 3 4 
1 3 1 0 0 0 0 0 0 0 0 0 0 2 102 0 0 0 0 0 0 0 0 0 0 0 0 0 0 0 0 0 0 0 0 0 0 0 0 2 1101 301 101 101 101 101 301 1102 2 301 0 0 0 0 0 601 601 408 601 0 0 0 0 0 0 0 0 0 0 0 0 0 0 3 4 
1 1 0 0 0 1801 0 0 1405 0 0 0 2 102 0 0 0 0 0 0 0 0 0 0 0 0 0 0 0 0 0 0 0 0 0 0 0 0 0 2 0 301 0 0 0 0 301 0 2 301 0 0 0 0 0 601 601 0 601 0 0 0 0 0 0 0 0 0 0 0 0 0 0 6 4 
1 1 0 0 0 301 2 2 2 2 2 2 102 0 0 0 0 0 0 0 0 0 0 0 0 0 0 0 0 0 0 0 0 0 0 0 0 0 0 2 0 301 0 0 0 0 301 0 2 301 0 0 0 0 0 601 601 0 601 0 0 0 0 0 0 0 0 407 0 0 0 0 0 3 1 
1 1 0 0 0 301 102 102 102 102 102 102 0 0 0 0 0 0 0 0 0 0 0 0 0 0 0 0 0 0 0 0 0 0 0 0 0 0 0 2 0 301 0 0 0 0 301 0 2 301 0 0 0 0 0 601 601 0 601 0 0 0 0 0 0 0 0 0 0 0 0 0 0 3 1 
1 6 0 0 0 301 0 0 0 0 0 0 0 0 1405 0 0 0 0 1405 0 0 0 0 1801 0 0 0 0 0 0 0 0 0 0 0 0 0 0 2 0 301 0 0 0 0 301 0 2 301 721 0 0 0 0 601 601 0 601 0 0 0 0 0 0 0 0 0 0 0 0 0 0 3 1 
1 6 2 2 2 2 2 2 2 2 2 2 2 2 2 2 2 2 2 2 2 2 2 2 2 301 0 0 0 0 0 0 0 0 0 0 0 0 0 2 0 301 601 601 601 601 301 0 2 301 0 0 0 0 0 601 601 0 601 0 0 0 0 0 0 0 0 0 0 0 0 0 0 3 4 
1 6 102 102 102 102 102 102 102 102 102 102 102 102 102 102 102 102 102 102 102 102 102 102 102 301 0 0 1405 0 0 1405 0 0 1801 0 0 0 0 2 101 101 101 101 101 101 101 0 2 301 0 0 0 0 0 601 601 0 601 0 0 0 0 0 0 0 0 0 0 0 0 0 0 3 4 
1 6 0 0 0 0 0 0 0 0 0 0 0 0 0 0 0 0 0 0 0 0 0 0 0 301 2 2 2 2 2 2 2 2 2 0 0 0 0 2 0 818 821 817 0 0 0 0 2 301 0 0 0 0 0 601 601 0 601 0 0 0 0 0 0 0 0 0 0 0 0 0 0 3 4 
1 6 0 0 0 0 0 0 0 0 0 0 0 0 0 0 0 0 0 0 0 0 0 0 0 301 102 102 102 102 102 102 102 102 102 2 0 0 0 101 101 447 411 447 0 0 101 101 101 301 0 0 0 0 410 1108 1107 406 601 0 0 1108 0 1107 601 601 601 601 1108 0 1107 0 0 3 4 
1 2 1401 1403 1405 1407 1411 1413 1415 1406 1406 1406 1406 1402 1407 0 1415 1415 0 1411 0 0 0 0 0 0 0 0 1412 1413 1415 1415 0 1403 0 101 2 0 0 0 0 412 0 412 0 1701 0 0 1801 301 1405 1405 1405 0 0 601 601 0 601 0 0 1108 1107 601 601 601 601 601 601 1108 1107 0 0 3 1 
4 2 11 1 1 1 1 1 1 1 1 1 1 1 1 1 1 1 1 1 1 1 1 1 1 1 1 1 1 1 1 1 1 1 1 1 1 2 0 0 0 412 0 412 1 1 1 1 1 1 1 1 1 1 1 1 1 1 1 1 1 1 1 1 1 1 1 1 1 1 1 1 12 2 1 
4 2 2 2 3 3 3 3 6 6 6 6 6 6 6 6 6 6 6 6 6 6 6 6 6 6 3 3 3 3 3 3 3 3 3 3 3 3 3 3 3 3 3 3 3 3 3 3 3 3 3 6 6 6 6 6 3 3 6 6 6 6 4 4 2 2 2 2 2 2 2 2 2 2 1 
1 4 4 1 1 1 1 1 1 1 4 4 4 4 4 4 4 4 4 1 1 1 1 1 1 1 1 1 1 1 1 1 4 4 1 4 1 4 4 4 4 4 1 1 1 1 4 4 4 4 4 1 4 4 1 1 1 1 1 1 1 1 1 1 1 4 4 4 4 4 4 4 4 4 4 
