1 1 1 1 1 1 1 1 1 1 1 1 1 1 1 1 1 1 1 1 1 1 1 1 1 
1 1 1 1 1 1 1 1 1 1 1 1 1 1 1 1 1 1 1 1 1 1 1 1 1 
1 1 1 1 1 1 1 1 1 1 1 1 1 1 1 1 1 1 1 1 1 1 1 1 1 
1 1 1 1 1201 0 0 0 0 0 0 0 0 0 0 0 0 0 0 0 1202 1 1 1 1 
1 1 1 1 1 1 1 1 1 22 0 0 0 0 0 21 1 1 1 1 1 1 1 1 1 
1 601 601 601 601 601 601 601 0 0 0 0 0 0 0 0 601 601 601 601 601 601 601 601 1 
1 601 601 601 601 601 601 601 601 0 0 0 0 0 0 0 601 601 601 601 601 601 601 601 1 
1 601 601 601 601 601 601 601 0 0 0 0 0 0 0 0 601 601 601 601 601 601 601 601 1 
1 601 601 601 601 601 601 601 0 0 0 0 0 0 0 0 601 601 601 601 601 601 601 601 1 
1 601 601 601 601 601 601 0 0 0 0 0 0 0 0 0 601 601 601 601 601 601 601 601 1 
1 601 601 601 601 601 0 0 0 0 0 0 0 0 0 0 601 601 601 601 601 601 601 601 1 
1 0 0 0 0 0 0 0 0 0 0 0 0 0 0 0 601 601 601 601 601 601 601 601 1 
1 0 0 0 0 0 0 0 0 0 0 0 0 0 0 0 601 601 601 601 601 601 601 601 1 
1 0 0 0 0 0 0 0 0 0 0 0 0 0 0 0 601 601 601 601 601 601 601 601 1 
1 0 0 0 0 0 0 0 0 0 0 0 0 0 0 0 601 601 601 601 601 601 601 601 1 
1 0 0 0 0 0 0 0 0 0 0 0 0 0 0 0 601 601 601 601 601 601 601 601 1 
1 0 0 0 0 0 0 0 0 0 0 0 0 0 0 0 601 601 601 601 601 601 601 601 1 
1 0 0 0 0 0 1701 1701 1701 0 0 0 0 0 0 0 601 601 601 601 601 601 601 601 1 
1 0 0 0 0 0 0 0 0 0 0 0 0 0 0 0 601 601 601 601 601 601 601 601 1 
1 0 0 0 0 0 0 0 0 0 0 0 0 0 0 0 601 601 601 601 601 601 601 601 1 
1 0 0 0 0 0 0 0 0 0 0 0 0 0 0 0 601 601 601 601 601 601 601 601 1 
1 0 0 0 0 0 0 0 0 0 0 0 0 0 0 0 601 601 601 601 601 601 601 601 1 
1 0 0 0 0 0 0 0 0 0 0 0 0 0 0 0 601 601 601 601 601 601 601 601 1 
1 0 0 0 0 0 0 0 0 0 0 0 0 0 0 0 601 601 601 601 601 601 601 601 1 
1 0 0 0 0 0 0 0 0 0 0 0 0 0 0 0 601 601 601 601 601 601 601 601 1 
1 0 0 0 0 0 0 0 0 0 0 0 0 0 0 0 601 601 601 601 601 601 601 601 1 
1 0 0 0 0 0 0 0 0 0 0 0 0 0 0 0 0 601 601 0 601 601 601 601 1 
1 0 0 0 0 0 0 0 0 0 0 0 0 0 0 0 0 0 601 601 601 601 601 601 1 
1 0 0 0 0 0 0 0 0 0 0 0 0 0 0 1701 1701 0 0 601 0 0 601 601 1 
1 0 0 0 0 0 0 0 0 0 0 0 0 0 0 0 0 0 0 0 601 601 0 601 1 
1 0 0 0 0 0 0 0 0 0 0 0 0 0 0 0 0 0 0 0 0 0 601 601 1 
1 0 0 0 0 0 0 0 0 0 0 0 0 0 0 0 0 0 0 0 0 601 601 601 1 
1 0 0 0 0 0 0 0 0 0 0 0 0 0 0 0 0 0 0 0 601 601 601 601 1 
1 0 0 0 0 0 0 0 0 0 0 0 0 0 0 0 0 0 0 601 601 601 601 601 1 
1 0 0 0 0 0 0 0 0 0 0 0 0 0 0 0 0 0 0 601 601 601 601 601 1 
1 0 0 0 0 0 0 0 0 0 0 0 0 0 0 0 0 0 601 601 601 601 601 601 1 
1 0 0 0 0 0 0 0 0 0 0 0 0 0 0 0 0 601 601 601 601 601 601 601 1 
1 0 0 0 0 0 0 0 0 0 0 0 0 0 0 0 601 601 601 601 601 601 601 601 1 
1 0 0 0 0 0 0 0 0 0 0 0 0 0 0 0 601 601 601 601 601 601 601 601 1 
1 0 0 0 0 0 0 0 0 0 0 0 0 0 0 0 601 601 601 601 601 601 601 601 1 
1 0 0 0 0 0 0 0 0 0 0 0 0 0 0 0 601 601 601 601 601 601 601 601 1 
1 0 0 0 0 0 0 0 0 0 0 0 0 0 0 0 601 601 601 601 601 601 601 601 1 
1 0 0 0 0 0 0 0 0 0 0 0 0 0 0 0 601 601 601 601 601 601 601 601 1 
1 0 0 0 0 0 0 0 0 0 0 0 0 0 0 0 601 601 601 601 601 601 601 601 1 
1 0 0 0 0 0 0 0 0 0 0 0 0 0 0 0 601 601 601 601 601 601 601 601 1 
1 0 0 0 1701 1701 1701 0 0 0 0 0 0 0 0 0 601 601 601 601 601 601 601 601 1 
1 0 0 0 0 0 0 0 0 0 0 0 0 0 0 0 601 601 601 601 601 601 601 601 1 
1 0 0 0 0 0 0 0 0 0 0 0 0 0 0 0 601 601 601 601 601 601 601 601 1 
1 0 0 0 0 0 0 0 0 0 0 0 0 0 0 0 601 601 601 601 601 601 601 601 1 
1 0 0 0 0 0 0 0 0 0 0 0 0 0 0 0 601 601 601 601 601 601 601 601 1 
1 0 0 0 0 0 0 0 0 0 0 0 0 0 0 0 601 601 601 601 601 601 601 601 1 
1 0 0 0 0 0 0 0 0 0 0 0 0 0 0 0 601 601 601 601 601 601 601 601 1 
1 0 0 0 0 0 0 0 0 0 0 0 0 0 0 0 601 601 601 601 601 601 601 601 1 
1 0 0 0 0 0 0 0 0 0 0 0 0 0 0 0 601 601 601 601 601 601 601 601 1 
1 0 0 0 0 0 0 0 0 0 0 0 0 0 0 0 601 601 601 601 601 601 601 601 1 
1 0 0 0 0 0 0 0 0 0 0 0 0 0 0 0 601 601 601 601 601 601 601 601 1 
1 0 0 0 0 0 0 0 0 0 0 0 0 0 0 0 601 601 601 601 601 601 601 601 1 
1 0 0 0 0 0 0 0 0 0 0 0 0 0 0 0 601 601 601 601 601 601 601 601 1 
1 0 0 0 0 0 0 0 0 0 1701 1701 0 0 0 0 601 601 601 601 601 601 601 601 1 
1 0 0 0 0 0 0 0 0 0 0 0 0 0 0 0 601 601 601 601 601 601 601 601 1 
1 0 0 0 0 0 0 0 0 0 0 0 0 0 0 0 601 601 601 601 601 601 601 601 1 
1 0 0 0 0 0 0 0 0 0 0 0 0 0 0 0 601 601 601 601 601 601 601 601 1 
1 0 0 0 0 0 0 0 0 0 0 0 0 0 0 0 0 601 601 601 601 601 601 601 1 
1 0 0 0 0 0 0 0 0 0 0 0 0 0 0 0 0 0 601 601 601 601 601 601 1 
1 0 0 0 0 0 0 0 0 0 0 0 0 0 0 0 0 0 0 601 601 601 601 601 1 
1 0 0 0 0 0 0 0 0 0 0 0 0 0 0 0 0 0 0 601 601 601 601 601 1 
1 0 0 0 0 0 0 0 0 0 0 0 0 0 0 0 0 0 0 0 601 601 601 601 1 
1 0 0 0 0 0 0 0 0 0 0 0 0 0 0 0 0 0 0 0 601 601 601 601 1 
1 0 0 0 0 0 0 0 0 0 0 0 0 0 0 0 1701 1701 0 0 601 601 601 601 1 
1 0 0 0 0 0 0 0 0 0 0 0 0 0 0 0 0 0 0 0 601 601 601 601 1 
1 0 0 0 0 0 0 0 0 0 0 0 0 0 0 0 0 0 0 0 601 601 601 601 1 
1 0 0 0 0 0 0 0 0 0 0 0 0 0 0 0 0 0 0 0 601 601 601 601 1 
1 0 0 0 0 0 0 0 0 0 0 0 0 0 0 0 0 0 0 601 601 601 601 601 1 
1 0 0 0 0 0 0 0 0 0 0 0 0 0 0 0 0 0 0 601 601 601 601 601 1 
1 0 0 0 0 0 0 0 0 0 0 0 0 0 0 0 0 0 601 601 601 601 601 601 1 
1 0 0 0 0 0 0 0 0 0 0 0 0 0 0 0 0 0 601 601 601 601 601 601 1 
1 0 0 0 0 0 0 0 0 0 0 0 0 0 0 0 0 601 601 601 601 601 601 601 1 
1 0 0 0 0 0 0 0 0 0 0 0 0 0 0 0 601 601 601 601 601 601 601 601 1 
1 0 0 0 0 0 0 0 0 0 0 0 0 0 0 0 601 601 601 601 601 601 601 601 1 
1 0 0 0 0 0 0 0 1701 1701 0 0 0 0 0 0 601 601 601 601 601 601 601 601 1 
1 0 0 0 0 0 0 0 0 0 0 0 0 0 0 0 601 601 601 601 601 601 601 601 1 
1 0 0 0 0 0 0 0 0 0 0 0 0 0 0 0 601 601 601 601 601 601 601 601 1 
1 0 0 0 0 0 0 0 0 0 0 0 0 0 0 0 601 601 601 601 601 601 601 601 1 
1 0 0 0 0 0 0 0 0 0 0 1106 0 0 0 0 601 601 601 601 601 601 601 601 1 
1 0 0 0 0 0 0 0 0 0 0 0 0 0 0 0 601 601 601 601 601 601 601 601 1 
1 0 0 0 0 0 0 0 0 0 0 0 1106 0 0 0 601 601 601 601 601 601 601 601 1 
1 0 0 0 0 0 0 0 0 0 0 0 0 1106 0 0 601 601 601 601 601 601 601 601 1 
1 0 0 0 0 0 0 0 0 0 0 0 0 0 0 0 601 601 601 601 601 601 601 601 1 
1 0 0 0 0 0 0 0 0 0 0 0 0 0 0 0 601 601 601 601 601 601 601 601 1 
1 0 0 0 0 0 0 0 0 0 0 0 0 1701 0 0 0 601 601 601 601 601 601 601 1 
1 0 0 0 0 0 0 0 0 0 0 0 0 0 0 0 0 0 601 601 601 601 601 601 1 
1 0 0 0 0 0 0 0 0 0 0 0 0 0 0 0 0 0 0 0 601 601 601 601 1 
1 0 0 0 0 0 0 0 0 0 0 0 0 0 0 0 0 0 0 0 601 601 601 601 1 
1 0 0 0 0 0 0 0 0 0 0 0 0 0 0 0 0 0 0 0 0 601 601 601 1 
1 0 0 0 0 0 0 0 0 0 0 0 0 0 0 0 0 0 0 0 0 601 601 601 1 
1 0 0 0 0 0 0 0 0 0 0 0 0 601 0 0 0 0 0 0 0 601 601 601 1 
1 0 0 0 0 0 0 0 0 0 0 0 0 0 0 0 0 1701 1701 1701 0 601 601 601 1 
1 0 0 0 0 0 0 0 0 0 0 0 601 0 0 0 0 0 0 0 0 601 601 601 1 
1 0 0 0 0 0 0 0 0 0 0 0 0 0 0 0 0 0 0 0 0 601 601 601 1 
1 0 0 0 0 0 0 0 0 0 0 0 0 0 0 0 0 0 0 0 0 601 601 601 1 
1 0 0 0 0 0 0 0 0 0 0 0 0 0 0 0 0 0 0 0 1107 601 601 601 1 
1 0 0 0 0 0 0 0 0 0 0 0 0 0 0 0 0 0 0 1107 601 601 601 601 1 
1 0 0 0 0 0 0 0 0 0 0 0 0 0 0 0 0 0 1107 601 601 601 601 601 1 
1 0 0 0 0 0 0 0 0 0 0 0 0 0 0 0 0 1107 601 601 601 601 601 601 1 
1 0 0 0 0 0 0 0 0 0 0 0 0 0 0 0 1107 601 601 601 601 601 601 601 1 
1 0 0 0 0 0 0 0 0 0 0 0 0 0 0 1107 601 601 601 601 601 601 601 601 1 
1 0 0 0 0 0 0 0 0 0 0 0 0 0 0 0 601 601 601 601 601 601 601 601 1 
1 1 1 1 1 1 1 1 1 1 0 0 0 0 0 1 1 1 1 1 1 1 1 1 1 
1 2 2 2 2 2 2 2 2 0 0 0 0 0 0 0 2 2 2 2 2 2 2 2 1 
1 2 2 2 2 2 2 2 2 0 0 0 0 0 0 0 2 2 2 2 2 2 2 2 1 
1 2 2 0 0 0 0 2 2 0 1 1 1 1 1 0 2 2 0 0 0 0 2 2 1 
1 2 2 0 1401 0 0 2 2 0 0 0 0 0 0 0 2 2 0 0 1406 0 2 2 1 
1 2 2 2 2 2 2 2 2 0 0 0 1301 0 0 0 2 2 2 2 2 2 2 2 1 
1 1 1 1 1 1 1 1 1 1 1 1 1 1 1 1 1 1 1 1 1 1 1 1 1 
