1 1 1 1 1 1 1 1 1 1 1 1 1 1 1 1 1 1 1 1 1 1 1 1 1 
1 0 0 0 0 0 0 0 0 0 0 0 0 0 0 0 0 0 0 0 0 0 0 0 1 
1 0 0 0 0 0 0 0 0 0 0 0 0 0 0 0 0 0 0 0 0 0 0 0 1 
1 0 0 0 0 0 0 0 0 0 0 0 0 0 0 0 0 0 0 0 0 0 0 0 1 
1 1 1 1 1 1 1 1 1 22 0 0 0 0 0 21 1 1 1 1 1 1 1 1 1 
1 601 601 601 601 601 601 601 1108 0 0 0 0 0 0 1107 601 601 601 601 601 601 601 601 1 
1 601 601 601 601 601 601 601 601 0 0 0 0 0 0 601 601 601 601 601 601 601 601 601 1 
1 601 601 601 601 601 601 601 601 0 0 0 0 0 0 601 601 601 601 601 601 601 601 601 1 
1 601 601 601 601 601 601 601 1105 0 0 0 0 0 0 601 601 601 601 601 601 601 601 601 1 
1 601 601 601 601 601 601 1105 0 0 0 0 0 0 1107 601 601 601 601 601 601 601 601 601 1 
1 601 601 601 601 601 601 0 0 0 0 0 0 1107 601 601 601 601 601 601 601 601 601 601 1 
1 601 601 601 601 601 1105 0 0 0 0 0 1107 601 601 601 601 601 601 601 601 601 601 601 1 
1 601 601 601 601 1105 0 0 0 0 0 0 601 601 601 601 601 601 601 601 601 601 601 601 1 
1 601 601 601 601 0 0 0 0 0 0 1107 601 601 601 601 601 601 601 601 601 601 601 601 1 
1 601 601 601 601 0 0 0 0 0 1107 601 601 601 601 601 601 601 601 601 601 601 601 601 1 
1 601 601 601 601 0 0 0 0 0 601 601 601 601 601 601 601 601 601 601 601 601 601 601 1 
1 601 601 601 601 0 0 0 0 0 601 601 601 601 601 601 601 601 601 601 601 601 601 601 1 
1 601 601 601 601 0 0 0 0 0 601 601 601 601 601 601 601 601 601 601 601 601 601 601 1 
1 601 601 601 601 0 0 0 0 0 601 601 601 601 601 601 601 601 601 601 601 601 601 601 1 
1 601 601 601 601 0 0 0 0 0 1106 601 601 601 601 601 601 601 601 601 601 601 601 601 1 
1 601 601 601 601 1108 0 0 0 0 0 1106 601 601 601 601 601 601 601 601 601 601 601 601 1 
1 601 601 601 601 601 0 0 0 0 0 0 1106 601 601 601 601 601 601 601 601 601 601 601 1 
1 601 601 601 601 601 1108 0 0 0 0 0 0 1106 601 601 601 601 601 601 601 601 601 601 1 
1 601 601 601 601 601 601 1108 0 0 0 0 0 0 1106 601 601 601 601 601 601 601 601 601 1 
1 601 601 601 601 601 601 601 1108 0 0 0 0 0 0 1106 601 601 601 601 601 601 601 601 1 
1 601 601 601 601 601 601 601 601 1108 0 0 0 0 0 0 601 601 601 601 601 601 601 601 1 
1 601 601 601 601 601 601 601 601 601 1108 0 0 0 0 0 1106 601 601 601 601 601 601 601 1 
1 601 601 601 601 601 601 601 601 601 601 1108 0 0 0 0 0 1106 601 601 601 601 601 601 1 
1 601 601 601 601 601 601 601 601 601 601 601 1108 0 0 0 0 0 1106 601 601 601 601 601 1 
1 601 601 601 601 601 601 601 601 601 601 601 601 1108 0 0 0 0 0 601 601 601 601 601 1 
1 601 601 601 601 601 601 601 601 601 601 601 601 601 0 0 0 0 0 601 601 601 601 601 1 
1 601 601 601 601 601 601 601 601 601 601 601 601 1105 0 0 0 0 0 601 601 601 601 601 1 
1 601 601 601 601 601 601 601 601 601 601 601 601 0 0 0 0 0 0 601 601 601 601 601 1 
1 601 601 601 601 601 601 601 601 601 601 601 1105 0 0 0 0 0 0 601 601 601 601 601 1 
1 601 601 601 601 601 601 601 601 601 601 1105 0 0 0 0 0 0 1107 601 601 601 601 601 1 
1 601 601 601 601 601 601 601 601 601 1105 0 0 0 0 0 0 1107 601 601 601 601 601 601 1 
1 601 601 601 601 601 601 601 601 1105 0 0 0 0 0 0 1107 601 601 601 601 601 601 601 1 
1 601 601 601 601 601 601 601 1105 0 0 0 0 0 0 1107 601 601 601 601 601 601 601 601 1 
1 601 601 601 601 601 601 1105 0 0 0 0 0 0 1107 601 601 601 601 601 601 601 601 601 1 
1 601 601 601 601 601 1105 0 0 0 0 0 0 1107 601 601 601 601 601 601 601 601 601 601 1 
1 601 601 601 601 1105 0 0 0 0 0 0 1107 601 601 601 601 601 601 601 601 601 601 601 1 
0 601 601 601 1105 0 0 0 0 0 0 1107 601 601 601 601 601 601 601 601 601 601 601 601 1 
0 601 601 1105 0 0 0 0 0 0 1107 601 601 601 601 601 601 601 601 601 601 601 601 601 1 
0 601 601 0 0 0 0 0 0 1107 601 601 601 601 601 601 601 601 601 601 601 601 601 601 1 
0 601 601 0 0 0 0 0 1107 601 601 601 601 601 601 601 601 601 601 601 601 601 601 601 1 
1 601 601 0 0 0 0 0 601 601 601 601 601 601 601 601 601 601 601 601 601 601 601 601 1 
1 601 601 0 0 0 0 0 601 601 601 601 601 601 601 601 601 601 601 601 601 601 601 601 1 
1 601 601 0 0 0 0 0 601 601 601 601 601 601 601 601 601 601 601 601 601 601 601 601 1 
1 601 601 0 0 0 0 0 1106 601 601 601 601 601 601 601 601 601 601 601 601 601 601 601 1 
1 601 601 1108 0 0 0 0 0 1106 601 601 601 601 601 601 601 601 601 601 601 601 601 601 1 
1 601 601 601 1108 0 0 0 0 0 1106 601 601 601 601 601 601 601 601 601 601 601 601 601 1 
1 601 601 601 601 0 0 0 0 0 0 601 601 601 601 601 601 601 601 601 601 601 601 601 1 
1 601 601 601 601 1108 0 0 0 0 0 601 601 601 601 601 601 601 601 601 601 601 601 601 1 
1 601 601 601 601 601 0 0 0 0 0 1106 601 601 601 601 601 601 601 601 601 601 601 601 1 
1 601 601 601 601 601 1108 0 0 0 0 0 601 601 601 601 601 601 601 601 601 601 601 601 1 
1 601 601 601 601 601 601 0 0 0 0 0 1106 601 601 601 601 601 601 601 601 601 601 601 1 
1 601 601 601 601 601 601 1108 0 0 0 0 0 601 601 601 601 601 601 601 601 601 601 601 1 
1 601 601 601 601 601 601 601 0 0 0 0 0 1106 601 601 601 601 601 601 601 601 601 601 1 
1 601 601 601 601 601 601 601 1108 0 0 0 0 0 1106 601 601 601 601 601 601 601 601 601 1 
1 601 601 601 601 601 601 601 601 0 0 0 0 0 0 601 601 601 601 601 601 601 601 601 1 
1 601 601 601 601 601 601 601 601 1108 0 0 0 0 0 1106 601 601 601 601 601 601 601 601 1 
1 601 601 601 601 601 601 601 601 601 0 0 0 0 0 0 601 601 601 601 601 601 601 601 1 
1 601 601 601 601 601 601 601 601 601 1108 0 0 0 0 0 1106 601 601 601 601 601 601 601 1 
1 601 601 601 601 601 601 601 601 601 601 0 0 0 0 0 0 1106 601 601 601 601 601 601 1 
1 601 601 601 601 601 601 601 601 601 601 1108 0 0 0 0 0 0 1106 601 601 601 601 601 1 
1 601 601 601 601 601 601 601 601 601 601 601 1108 0 0 0 0 0 0 601 601 601 601 601 1 
1 601 601 601 601 601 601 601 601 601 601 601 601 0 0 0 0 0 0 1106 601 601 601 601 1 
1 601 601 601 601 601 601 601 601 601 601 601 601 1108 0 0 0 0 0 0 601 601 601 601 1 
1 601 601 601 601 601 601 601 601 601 601 601 601 601 1108 0 0 0 0 0 601 601 601 601 1 
1 601 601 601 601 601 601 601 601 601 601 601 601 601 601 0 0 0 0 0 601 601 601 601 1 
1 601 601 601 601 601 601 601 601 601 601 601 601 601 601 0 0 0 0 0 601 601 601 601 1 
1 601 601 601 601 601 601 601 601 601 601 601 601 601 1105 0 0 0 0 1107 601 601 601 601 1 
1 601 601 601 601 601 601 601 601 601 601 601 601 1105 0 0 0 0 0 601 601 601 601 601 1 
1 601 601 601 601 601 601 601 601 601 601 601 1105 0 0 0 0 0 1107 601 601 601 601 601 1 
1 601 601 601 601 601 601 601 601 601 601 1105 0 0 0 0 0 0 601 601 601 601 601 601 1 
1 601 601 601 601 601 601 601 601 601 1105 0 0 0 0 0 0 1107 601 601 601 601 601 601 1 
1 601 601 601 601 601 601 601 601 1105 0 0 0 0 0 0 1107 601 601 601 601 601 601 601 1 
1 601 601 601 601 601 601 601 1105 0 0 0 0 0 0 1107 601 601 601 601 601 601 601 601 1 
1 601 601 601 601 601 601 1105 0 0 0 0 0 0 1107 601 601 601 601 601 601 601 601 601 1 
1 601 601 601 601 601 1105 0 0 0 0 0 0 1107 601 601 601 601 601 601 601 601 601 601 1 
1 601 601 601 601 601 0 0 0 0 0 0 1107 601 601 601 601 601 601 601 601 601 601 601 1 
1 601 601 601 601 601 0 0 0 0 0 1107 601 601 601 601 601 601 601 601 601 601 601 601 1 
1 601 601 601 601 601 0 0 0 0 0 601 601 601 601 601 601 601 601 601 601 601 601 601 1 
1 601 601 601 601 601 1108 0 0 0 0 1106 601 601 601 601 601 601 601 601 601 601 601 601 1 
1 601 601 601 601 601 601 0 0 0 0 0 601 601 601 601 601 601 601 601 601 601 601 601 1 
1 601 601 601 601 601 601 1108 0 0 0 0 1106 601 601 601 601 601 601 601 601 601 601 601 1 
1 601 601 601 601 601 601 601 0 0 0 0 0 1106 601 601 601 601 601 601 601 601 601 601 1 
1 601 601 601 601 601 601 601 1108 0 0 0 0 0 1106 601 601 601 601 601 601 601 601 601 1 
1 601 601 601 601 601 601 601 601 0 0 0 0 0 0 1106 601 601 601 601 601 601 601 601 1 
1 601 601 601 601 601 601 601 601 1108 0 0 0 0 0 0 1106 601 0 0 0 601 601 601 1 
1 601 601 601 601 601 601 601 601 601 1108 0 0 0 0 0 0 1106 0 601 0 0 601 601 1 
1 601 601 601 601 601 601 601 601 601 601 1108 0 0 0 0 0 0 1106 601 601 0 0 601 1 
1 601 601 601 601 601 601 601 601 601 601 601 1108 0 0 0 0 0 0 1106 0 601 0 0 1 
1 601 601 601 601 601 601 601 601 601 601 601 601 1108 0 0 0 0 0 0 1106 0 0 601 1 
1 601 601 601 601 601 601 601 601 601 601 601 601 601 1108 0 0 0 0 0 0 0 601 601 1 
1 601 601 601 601 601 601 601 601 601 601 601 601 601 601 1108 0 0 0 0 0 601 601 601 1 
1 601 601 601 601 601 601 601 601 601 601 601 601 601 601 601 0 0 0 0 0 601 601 601 1 
1 601 601 601 601 601 601 601 601 601 601 601 601 601 601 601 0 0 0 0 0 601 601 601 1 
1 601 601 601 601 601 601 601 601 601 601 601 601 601 601 601 0 0 0 0 0 0 601 601 1 
1 601 601 601 601 601 601 601 601 601 601 601 601 601 601 601 0 0 0 0 0 0 601 601 1 
1 601 601 601 601 601 601 601 601 601 601 601 601 601 601 1105 0 0 0 0 0 601 601 601 1 
1 601 601 601 601 601 601 601 601 601 601 601 601 601 1105 0 0 0 0 0 601 601 601 601 1 
1 601 601 601 601 601 601 601 601 601 601 601 601 1105 0 0 0 0 0 601 601 601 601 601 1 
1 601 601 601 601 601 601 601 601 601 601 601 1105 0 0 0 0 0 601 601 601 601 601 601 1 
1 601 601 601 601 601 601 601 601 601 601 1105 0 0 0 0 0 601 601 601 601 601 601 601 1 
1 601 601 601 601 601 601 601 601 601 1105 0 0 0 0 0 601 601 601 601 601 601 601 601 1 
1 601 601 601 601 601 601 601 601 1105 0 0 0 0 0 601 601 601 601 601 601 601 601 601 1 
1 0 0 0 0 0 0 0 0 0 0 0 0 0 0 0 0 0 0 0 0 0 0 0 1 
1 0 0 0 0 0 0 0 0 0 0 0 0 0 0 0 0 0 0 0 0 0 0 0 1 
1 0 0 0 0 0 0 0 0 0 0 0 0 0 0 0 0 0 0 0 0 0 0 0 1 
1 0 0 0 0 0 0 0 0 0 1 1 1 1 1 0 0 0 0 0 0 0 0 0 1 
1 0 0 0 0 0 0 0 0 0 0 0 0 0 0 0 0 0 0 0 0 0 0 0 1 
1 0 0 0 0 0 0 0 0 0 0 0 0 0 0 0 0 0 0 0 0 0 0 0 1 
1 1 1 1 1 1 1 1 1 1 1 1 1 1 1 1 1 1 1 1 1 1 1 1 1 
